2 2 2 2 2 2 2 2 2 2 2 2 2 2 2 2 2 2 2 2 2 2 2 2 2 2 2 2 2 2 2 2 2 0 0 0 0 0 0 0 0 0 0 0 0 0 0 0 0 0 
2 2 2 2 2 2 2 2 2 2 2 2 2 2 2 2 2 2 2 2 2 2 2 2 2 2 2 2 2 2 2 2 0 0 0 0 0 0 0 0 0 0 0 0 0 0 0 0 0 0 
2 2 2 2 2 3 3 3 4 3 3 3 2 2 2 2 3 3 4 2 2 2 2 2 2 2 2 2 2 2 2 2 0 0 0 0 7 7 7 7 7 7 7 0 0 0 0 0 0 0 
2 2 2 2 2 2 2 2 2 2 2 3 4 3 3 2 3 2 3 2 2 2 2 2 2 2 2 2 2 2 2 0 0 0 0 0 7 5 5 5 5 5 7 0 0 0 0 0 0 0 
2 2 2 2 3 3 3 2 2 2 2 2 2 2 4 3 3 2 3 2 2 2 2 2 2 2 2 2 2 0 0 0 0 0 0 0 7 5 5 5 5 5 7 0 0 0 0 0 0 0 
2 2 2 2 3 4 3 2 3 2 3 3 3 2 2 2 2 2 4 2 2 2 2 2 2 2 2 0 0 0 0 0 0 0 0 0 7 5 5 5 5 5 7 0 0 0 0 0 0 0 
2 3 3 2 3 3 3 3 2 2 2 3 4 2 2 2 2 2 4 3 3 3 2 2 2 3 1 0 0 0 0 0 0 0 0 0 7 5 5 5 5 5 7 0 0 0 0 0 0 0 
2 3 2 2 2 2 2 3 3 3 2 2 3 2 2 2 2 2 2 2 2 3 2 2 2 1 1 0 0 0 0 0 0 0 0 0 7 5 5 5 5 5 7 0 0 0 0 0 0 0 
2 4 2 2 2 2 2 2 2 3 2 2 3 3 3 4 3 3 2 2 2 4 2 2 2 1 1 0 0 0 0 0 0 0 0 0 7 7 5 5 5 7 7 0 0 0 0 0 0 0 
2 4 2 3 3 3 3 3 3 3 2 2 2 2 2 3 2 3 2 2 2 3 2 2 3 1 1 0 0 0 0 0 0 0 0 0 0 0 5 5 5 0 0 0 0 0 0 0 0 0 
2 3 3 3 2 2 2 2 2 2 3 2 2 2 2 3 2 3 2 2 2 3 3 4 1 1 1 0 0 0 0 0 0 0 0 0 0 5 5 5 5 0 0 0 0 0 0 0 0 0 
2 2 2 3 3 3 2 2 2 2 2 4 3 3 3 3 2 4 2 2 3 3 6 3 1 1 1 0 0 0 0 0 0 0 0 0 5 5 5 5 5 0 0 0 0 0 0 0 0 2 
2 2 2 2 2 4 2 2 2 2 2 3 2 2 2 2 2 3 2 2 3 6 6 3 1 1 1 0 0 0 0 0 0 0 0 5 5 5 5 0 0 0 0 0 0 0 0 2 2 2 
2 2 2 3 3 3 3 2 2 2 3 3 2 2 2 2 2 3 3 3 3 6 6 1 1 1 1 1 0 0 0 0 0 0 5 5 5 5 0 0 0 0 0 0 0 0 0 2 2 2 
2 2 2 3 2 2 2 2 3 3 3 3 2 2 2 2 2 2 3 6 6 6 3 1 1 1 1 1 1 0 0 0 0 5 5 5 5 0 0 0 0 0 0 0 0 0 2 2 2 2 
2 2 2 4 2 2 2 3 3 2 2 2 2 2 2 3 3 3 3 6 6 3 4 1 1 1 1 1 1 1 0 0 5 5 5 5 0 0 0 0 0 0 0 0 0 0 2 2 2 2 
2 2 2 3 2 2 2 2 3 2 2 2 3 3 3 3 3 3 3 3 6 6 3 3 1 1 1 1 1 1 1 1 1 5 5 0 0 0 0 0 0 0 0 0 0 1 2 2 2 2 
2 2 2 3 3 3 3 4 3 2 2 2 3 3 3 3 3 3 3 3 6 6 3 3 1 1 1 1 1 1 1 1 1 1 1 1 0 0 0 0 0 0 0 0 1 1 2 2 2 2 
2 2 2 2 2 2 2 2 2 2 3 3 3 3 3 4 3 3 3 3 6 6 6 4 3 1 1 1 1 1 1 1 1 1 1 1 1 1 1 1 1 1 1 1 1 1 3 2 2 2 
2 2 2 2 2 2 2 3 3 3 3 3 3 4 3 3 3 2 3 6 6 6 6 6 3 3 1 1 1 1 1 1 1 1 1 1 1 1 1 1 1 1 1 1 3 3 3 2 2 2 
2 2 2 2 2 2 3 3 3 3 3 3 3 3 3 3 3 6 6 6 6 6 6 6 6 3 3 4 1 1 1 1 1 1 1 1 1 1 1 1 1 1 1 3 3 3 3 2 2 2 
2 2 2 2 2 3 3 3 3 3 3 3 3 3 3 3 6 6 6 6 6 6 6 6 6 6 6 3 3 1 1 1 1 1 1 1 1 1 1 1 1 3 3 3 3 4 3 2 2 2 
2 2 2 2 3 3 3 3 4 3 3 3 3 3 3 6 6 6 3 3 6 6 6 3 3 6 6 6 6 6 1 1 1 1 1 1 1 1 3 3 3 3 3 3 3 3 3 2 2 2 
2 2 2 3 3 3 3 3 3 3 3 3 4 3 6 6 6 3 3 3 3 6 6 3 4 3 6 6 6 3 3 3 3 3 3 3 3 3 3 3 3 3 3 3 3 3 3 2 2 2 
2 2 2 2 3 3 3 3 3 3 3 3 3 3 6 6 3 3 3 3 3 6 6 3 3 3 3 3 3 3 4 3 3 3 3 3 3 2 3 4 3 3 3 4 3 3 3 2 2 2 
2 2 2 2 3 3 3 2 3 3 3 3 3 6 6 6 3 3 3 4 3 3 6 6 3 3 3 3 3 3 3 3 3 3 3 3 3 3 3 4 3 3 3 3 3 3 3 2 2 2 
2 2 2 2 3 3 3 3 2 3 3 3 6 6 6 3 3 3 3 3 3 3 6 6 6 3 2 4 3 3 3 3 3 3 3 3 3 3 3 3 3 3 3 3 3 3 3 2 2 2 
2 2 2 2 3 3 3 3 3 3 3 6 6 6 3 3 3 3 3 3 3 3 3 6 6 6 3 3 3 7 7 7 7 7 7 7 7 7 7 7 7 7 7 3 3 3 2 2 2 2 
2 2 2 2 3 3 3 3 3 3 6 6 6 3 3 3 4 3 3 3 3 3 3 3 6 6 3 3 3 7 5 5 5 5 5 5 5 5 5 5 5 5 7 3 3 3 2 2 2 2 
2 2 2 2 3 3 3 3 3 3 6 6 3 3 3 3 3 3 3 3 3 3 3 2 6 6 6 3 3 7 5 5 5 5 5 5 5 5 5 5 5 5 7 3 3 3 2 2 2 2 
2 2 2 2 3 3 4 3 3 3 6 6 3 3 2 3 3 3 3 4 3 3 3 3 3 6 6 6 6 7 5 5 5 5 5 5 5 5 5 5 5 5 7 3 3 4 2 2 2 2 
2 2 2 2 3 3 3 3 3 6 6 6 3 3 3 3 3 3 3 3 3 3 3 3 3 3 6 6 6 5 5 5 5 5 5 5 5 5 5 5 5 5 7 3 3 3 2 2 2 2 
2 2 2 2 3 3 3 3 3 6 6 3 3 3 3 3 3 3 3 3 3 3 3 3 3 3 3 3 6 7 5 5 5 5 5 5 5 5 5 5 5 5 7 3 3 3 3 3 2 2 
2 2 2 2 3 3 3 2 3 6 6 3 3 3 3 3 3 3 3 2 3 3 3 3 3 3 3 3 3 7 5 5 5 5 5 7 7 5 7 7 5 5 7 3 3 3 3 3 2 2 
2 2 2 2 3 3 3 3 6 6 6 3 3 3 3 3 3 3 3 3 3 3 3 4 3 3 3 3 3 7 5 5 5 5 5 7 5 5 5 7 5 5 7 3 2 3 3 3 2 2 
2 2 2 2 3 3 3 3 6 6 3 2 3 3 3 3 4 3 3 3 3 3 3 3 3 3 3 3 3 7 7 7 7 7 7 7 5 5 5 7 7 7 7 3 3 3 4 3 2 2 
2 2 2 3 3 3 2 6 6 6 3 3 3 3 3 3 3 3 3 3 3 3 3 3 3 3 3 3 3 3 3 3 3 3 3 7 5 5 5 7 3 3 3 3 3 3 3 3 2 2 
2 2 2 3 3 4 3 6 6 3 3 3 3 3 3 3 3 3 3 3 3 3 3 3 3 3 3 3 3 3 4 3 3 3 3 7 5 5 5 7 3 3 3 3 3 3 3 3 2 2 
2 2 2 3 3 3 3 6 6 3 3 3 3 4 3 3 3 2 3 3 3 3 4 3 3 3 3 3 3 3 3 3 3 3 7 7 7 5 7 7 7 3 3 3 3 3 3 3 2 2 
2 2 2 3 3 3 6 6 6 3 3 3 3 3 3 3 3 3 3 3 3 3 3 3 3 2 3 3 3 3 3 3 3 3 7 5 5 5 5 5 7 3 3 4 3 2 3 2 2 2 
2 2 2 3 3 6 6 6 6 6 3 3 4 3 3 3 3 3 3 3 3 3 3 3 3 3 3 3 4 3 3 3 4 3 7 5 5 5 5 5 7 3 3 3 3 2 3 2 2 2 
2 2 2 3 3 6 6 6 6 6 3 3 3 3 3 3 3 4 3 3 3 4 3 3 3 3 3 3 3 3 3 3 3 3 7 5 5 5 5 5 7 3 3 3 3 3 3 2 2 2 
2 2 3 3 3 6 6 6 6 6 3 3 3 3 2 3 3 3 3 3 3 3 3 3 3 3 4 3 3 3 3 3 3 3 7 5 5 5 5 5 7 3 3 2 3 3 2 2 2 2 
2 2 3 4 3 3 6 6 6 3 3 3 3 3 3 3 3 3 3 3 3 3 3 3 3 3 3 3 3 3 2 3 3 3 7 5 5 5 5 5 7 3 3 3 3 3 2 2 2 2 
2 2 3 3 3 3 3 3 3 3 3 3 3 3 3 3 3 3 3 3 4 3 3 3 3 2 3 3 3 3 3 3 3 3 7 7 7 7 7 7 7 3 4 3 3 2 2 2 2 2 
2 2 2 3 3 3 3 3 4 3 3 2 3 3 3 3 3 3 3 3 3 3 3 3 3 3 3 3 3 3 3 3 3 3 3 3 3 3 3 2 3 3 3 3 2 2 2 2 2 2 
2 2 2 2 3 3 3 3 3 3 2 2 2 2 2 2 2 2 3 3 3 3 3 3 4 3 3 2 2 2 2 2 2 2 2 2 3 3 3 3 3 3 2 2 2 2 2 2 2 2 
2 2 2 2 2 2 3 2 2 2 2 2 2 2 2 2 2 2 3 3 3 3 3 3 2 2 2 2 2 2 2 2 2 2 2 2 2 2 2 2 2 2 2 2 2 2 2 2 2 2 
2 2 2 2 2 2 2 2 2 2 2 2 2 2 2 2 2 2 2 2 2 2 2 2 2 2 2 2 2 2 2 2 2 2 2 2 2 2 2 2 2 2 2 2 2 2 2 2 2 2 
2 2 2 2 2 2 2 2 2 2 2 2 2 2 2 2 2 2 2 2 2 2 2 2 2 2 2 2 2 2 2 2 2 2 2 2 2 2 2 2 2 2 2 2 2 2 2 2 2 2 
